111111111111111111111111
100P00100000000000000001
111111100000000000000001
1000000000000001000001E1
111111011111111111111111
100000000000000111111001
100000000111111001000001
10000000000000C00C001001
111111111111111111111111